a=阿
i=呜
e=夜
o=喔
ka=卡
ki=[KI]
ku=哭
ke=[KIE]
ko=阔
sa=[SA]
shi=[SHE]
su=素
se=写
so=缩
ta=他
chi=其
tsu=粗
te=铁
to=拖
na=那
ni=你
nu=怒
ne=捏
no=诺
ha=哈
hi=[HI]
hu=呼
he=[HIE]
ho=货
ma=妈
mi=米
mu=木
me=灭
mo=摸
ya=呀
yu=于
yo=哟
ra=啦
ri=里
ru=鲁
re=列
ro=咯
wa=挖
wo=我
n=嗯